# Register map generated at: 24/03/2020 15:25:18
# using: /epics/iocs/cmds/pkt-mux-cmd/dgro_master/det_param_gen/src/param_parse.py
# Register definition file: ../../param_def/
# Project: Detector Group Readout Master
# Register space: Ring Configuration Register Space (Master)

LPBK 0xc0000000 LW
PHASH 0xc0000004 LW
GTPG 0xc0000008 LW
RGTY 0xc000000c LW
RTXD 0xc0000010 LW
RRXD 0xc0000014 LW
RBAL 0xc0000018 LW
RS00 0xc000001c LW
RS01 0xc0000020 LW
RS02 0xc0000024 LW
RS03 0xc0000028 LW
RS04 0xc000002c LW
RS05 0xc0000030 LW
RS06 0xc0000034 LW
RS07 0xc0000038 LW
RS08 0xc000003c LW
RS09 0xc0000040 LW
RS10 0xc0000044 LW
RS11 0xc0000048 LW
RS12 0xc000004c LW
RS13 0xc0000050 LW
RS14 0xc0000054 LW
RS15 0xc0000058 LW
RS16 0xc000005c LW
RS17 0xc0000060 LW
RS18 0xc0000064 LW
RS19 0xc0000068 LW
RS20 0xc000006c LW
RS21 0xc0000070 LW
RS22 0xc0000074 LW
RS23 0xc0000078 LW
TS00 0xc000007c LW
TS01 0xc0000080 LW
TS02 0xc0000084 LW
TS03 0xc0000088 LW
TS04 0xc000008c LW
TS05 0xc0000090 LW
TS06 0xc0000094 LW
TS07 0xc0000098 LW
TS08 0xc000009c LW
TS09 0xc00000a0 LW
TS10 0xc00000a4 LW
TS11 0xc00000a8 LW
TS12 0xc00000ac LW
TS13 0xc00000b0 LW
TS14 0xc00000b4 LW
TS15 0xc00000b8 LW
TS16 0xc00000bc LW
TS17 0xc00000c0 LW
TS18 0xc00000c4 LW
TS19 0xc00000c8 LW
TS20 0xc00000cc LW
TS21 0xc00000d0 LW
TS22 0xc00000d4 LW
TS23 0xc00000d8 LW
TNS00 0xc00000dc LW
TNS01 0xc00000e0 LW
TNS02 0xc00000e4 LW
RNS00 0xc00000e8 LW
RNS01 0xc00000ec LW
RNS02 0xc00000f0 LW
TCS00 0xc00000f4 LW
TCS01 0xc00000f8 LW
TCS02 0xc00000fc LW
PDPL 0xc0000100 LW
RCS00 0xc0000104 LW
RCS01 0xc0000108 LW
RCS02 0xc000010c LW
RBWD 0xc0000110 LW
SRST 0xc0000114 LW
RVSR 0xc0000118 LW
TDIR 0xc000011c LW
RDIR 0xc0000120 LW
TYM_0 0xc0000124 LW
TYM_1 0xc0000128 LW
LDST 0xc000012c LW
MS00 0xc0000130 LW
MS01 0xc0000134 LW
MS02 0xc0000138 LW
MS03 0xc000013c LW
MS04 0xc0000140 LW
MS05 0xc0000144 LW
MS06 0xc0000148 LW
MS07 0xc000014c LW
MS08 0xc0000150 LW
MS09 0xc0000154 LW
MS10 0xc0000158 LW
MS11 0xc000015c LW
MS12 0xc0000160 LW
MS13 0xc0000164 LW
MS14 0xc0000168 LW
MS15 0xc000016c LW
MS16 0xc0000170 LW
MS17 0xc0000174 LW
MS18 0xc0000178 LW
MS19 0xc000017c LW
MS20 0xc0000180 LW
MS21 0xc0000184 LW
MS22 0xc0000188 LW
MS23 0xc000018c LW
TM00 0xc0000190 LW
TM01 0xc0000194 LW
TM02 0xc0000198 LW
TM03 0xc000019c LW
TM04 0xc00001a0 LW
TM05 0xc00001a4 LW
TM06 0xc00001a8 LW
TM07 0xc00001ac LW
TM08 0xc00001b0 LW
TM09 0xc00001b4 LW
TM10 0xc00001b8 LW
TM11 0xc00001bc LW
TM12 0xc00001c0 LW
TM13 0xc00001c4 LW
TM14 0xc00001c8 LW
TM15 0xc00001cc LW
TM16 0xc00001d0 LW
TM17 0xc00001d4 LW
TM18 0xc00001d8 LW
TM19 0xc00001dc LW
TM20 0xc00001e0 LW
TM21 0xc00001e4 LW
TM22 0xc00001e8 LW
TM23 0xc00001ec LW
RM00 0xc00001f0 LW
RM01 0xc00001f4 LW
RM02 0xc00001f8 LW
RM03 0xc00001fc LW
RM04 0xc0000200 LW
RM05 0xc0000204 LW
RM06 0xc0000208 LW
RM07 0xc000020c LW
RM08 0xc0000210 LW
RM09 0xc0000214 LW
RM10 0xc0000218 LW
RM11 0xc000021c LW
RM12 0xc0000220 LW
RM13 0xc0000224 LW
RM14 0xc0000228 LW
RM15 0xc000022c LW
RM16 0xc0000230 LW
RM17 0xc0000234 LW
RM18 0xc0000238 LW
RM19 0xc000023c LW
RM20 0xc0000240 LW
RM21 0xc0000244 LW
RM22 0xc0000248 LW
RM23 0xc000024c LW
TMOF 0xc0000250 LW
TPLS 0xc0000254 LW
TDUR 0xc0000258 LW
MN00 0xc000025c LW
MN01 0xc0000260 LW
MN02 0xc0000264 LW
MN03 0xc0000268 LW
MN04 0xc000026c LW
MN05 0xc0000270 LW
MN06 0xc0000274 LW
MN07 0xc0000278 LW
MN08 0xc000027c LW
MN09 0xc0000280 LW
MN10 0xc0000284 LW
MN11 0xc0000288 LW
MN12 0xc000028c LW
MN13 0xc0000290 LW
MN14 0xc0000294 LW
MN15 0xc0000298 LW
MN16 0xc000029c LW
MN17 0xc00002a0 LW
MN18 0xc00002a4 LW
MN19 0xc00002a8 LW
MN20 0xc00002ac LW
MN21 0xc00002b0 LW
MN22 0xc00002b4 LW
MN23 0xc00002b8 LW
PLEN 0xc00002bc LW
RSRX 0xc00002c0 LW
